111100000000000000-
000101110000000000-
000101010000000000-
000111010001111100-
000000010001000000-
001111110001000000-
001000000001000000-
001111111111000000-
000000000000000000-
000000000000000000-
000000000000000000